1000000000
0002000100
1111101102
1021000211
1000000000
0001111002
2010211011
0110000000
0000011010
2000001000