1000000000
0002000100
1111101102
1021000211
1000000000
0001111002
2010211011
0110000000
0000011010
2000001000

1111000000
1201020000
1001000001
1000020001
0000000001
1000000000
0000000000
0000100000
0000200111
0000000021
